09,09,09,09,09,09,09,09,09,09,09,09,09,09,09,09,09,09,09,09,09,09,09,09,09,09 
07,07,07,07,07,07,07,07,07,07,07,07,07,07,07,07,07,07,07,07,07,07,07,07,07,07
08,08,08,08,08,08,08,08,08,08,08,08,08,08,08,08,08,08,08,08,08,08,08,08,08,08
06,06,06,06,06,06,06,06,06,06,06,06,06,06,06,06,06,06,06,06,06,06,06,06,06,06
12,12,12,06,06,06,06,06,06,06,06,06,06,06,06,06,06,06,06,06,06,06,06,06,06,06
20,20,20,20,21,21,21,06,06,06,06,06,06,06,06,06,06,06,06,06,06,06,06,06,06,06
20,06,06,06,21,21,21,06,06,06,06,06,06,06,06,06,06,06,06,06,06,06,06,06,06,06
06,06,06,20,21,21,21,06,06,06,06,06,06,06,06,06,06,06,06,06,06,06,06,06,06,06
06,06,06,06,06,06,06,06,06,06,06,06,06,06,06,06,06,06,06,06,06,06,06,06,06,06
06,06,06,06,06,06,06,06,06,06,06,06,06,06,06,06,06,06,06,06,06,06,06,06,06,06