05,05,00,00,00,00,00,00,00,00,00,00,00,00,00,00,00,00,00,00,00,00,00,05,05
05,00,01,00,01,00,00,00,00,00,00,00,00,00,00,00,00,00,00,00,00,00,00,00,05
00,00,01,01,01,01,00,00,00,00,00,00,00,00,00,00,00,00,00,01,01,01,00,00,00
00,00,01,01,01,01,00,00,00,00,00,00,00,00,00,00,00,00,00,01,01,01,00,00,00
00,00,01,01,01,01,00,00,00,00,00,00,00,00,00,00,00,00,00,01,01,01,00,00,00
00,01,01,01,01,01,00,00,00,00,00,00,01,00,00,00,00,01,01,01,01,01,00,00,00
00,01,01,01,01,01,00,00,00,00,00,00,01,00,00,00,01,01,01,01,01,01,00,00,00
00,01,01,01,00,01,00,00,00,00,00,00,01,00,00,00,01,01,01,01,01,01,00,00,00
00,01,00,01,00,01,00,00,00,00,26,00,01,01,00,01,01,01,01,01,01,01,00,00,00
00,01,01,01,00,01,00,00,00,00,26,00,01,01,00,01,01,01,01,01,01,01,00,00,05
00,01,01,01,00,01,04,00,00,00,26,00,00,01,00,01,01,01,01,01,01,01,00,00,00
00,00,01,01,00,01,00,00,00,00,26,00,00,01,01,01,01,01,01,01,01,01,00,05,00
26,27,23,24,25,26,27,23,24,25,26,03,00,01,01,01,01,01,01,01,01,05,05,00,00
00,00,01,00,02,00,00,01,00,01,00,00,00,00,01,05,01,01,01,00,05,05,05,00,05
00,00,01,00,04,04,00,01,00,01,00,00,00,00,01,01,01,01,01,05,05,05,00,05,00
00,00,00,02,03,04,00,01,00,01,02,03,00,00,01,01,05,01,01,05,05,03,00,05,05
00,00,00,02,04,03,01,01,01,01,00,04,00,00,00,01,01,00,05,05,02,05,05,00,00
00,00,00,02,03,03,01,01,01,03,03,03,00,00,00,01,00,05,00,05,02,05,00,00,00
05,00,00,00,01,03,01,01,01,04,04,03,00,00,00,01,00,00,00,05,05,05,05,00,05
05,05,00,00,01,00,01,01,01,00,00,00,00,00,00,00,00,00,00,00,00,00,00,05,05